0000000000000
0000000010000
0011199911100
0010222220100
0010900090100
0010100001100
0011121911100
0011222111100
0000000000000
0000000000000
